[
    {
        "id":1,
        "data":[
            [0, 0, 0, 0, 0, 0, 0, 0, 0],
            [0, 2, 0, 0, 0, 2, 0, 0, 0],
            [0, 0, 0, 0, 0, 8, 8, 0, 0],
            [0, 0, 0, 0, 0, 8, 8, 0, 0],
            [0, 0, 0, 2, 0, 0, 0, 0, 0],
            [0, 0, 0, 0, 0, 0, 0, 0, 0],
            [0, 0, 0, 0, 1, 0, 2, 0, 0],
            [0, 0, 0, 0, 0, 0, 0, 0, 0],
            [0, 0, 0, 0, 0, 0, 0, 0, 0]
        ],
        "peopleX":5,
        "peopleY":6,
        "score":4
    },
    {
        "id":2,
        "data":[
            [0, 8, 0, 2, 0, 0, 0, 0, 0],
            [0, 8, 0, 0, 0, 2, 0, 2, 0],
            [0, 8, 0, 0, 2, 0, 0, 2, 0],
            [0, 8, 0, 0, 0, 8, 0, 0, 0],
            [0, 8, 0, 2, 0, 0, 0, 2, 0],
            [0, 8, 0, 0, 0, 0, 0, 0, 0],
            [0, 8, 0, 0, 1, 0, 2, 0, 0],
            [0, 8, 0, 0, 0, 0, 2, 2, 0],
            [0, 8, 0, 0, 0, 0, 0, 0, 0]
        ],
        "peopleX":0,
        "peopleY":1,
        "score":10
    }
]